WWWWWWWWWWWWWWWWWWWWWWWWW
W...W.................WWW
W.@.....................W
W.................E.....W
WWWWW...............WWWWW
W...........W...........W
W.......................W
W.......................W
W.......................W
W.......................W
W.......................W
W.......................W
W.......................W
WWWWWWWWWWWWWWWWWWWWWWWWW