WWWWWWWWWWWWWWWWWWWWWWWWW
W...WssssssWW.........WWW
W.@.WssssssWW...........W
W....ssssssWW.....E.....W
WWW.lllllllWW...........W
W..........WW...........W
W..........WW...........W
W..........WW...........W
W..........WW...........W
W...E......WW........@..W
W..........WW...........W
WsssssssssssssssssssssssW
WsssssssssssssssssssssssW
WWWWWWWWWWWWWWWWWWWWWWWWW