WWWWWWWWWWWWWWWWWWWWWWWWW
WsssW......WW.........WWW
Ws@sW......WW.E.........W
Wssss...E..WW.....E.....W
WWWss......WW........E..W
W.....E....WW.....E.....W
W..E....E..WW...E.......W
W..........WW...........W
W...E..E...WW......WsssWW
W..........WW..E...ss@ssW
W....E.....WW......ssssWW
W.....E...E....E...E....W
W.......................W
WWWWWWWWWWWWWWWWWWWWWWWWW