WWWWWWWWWWWWWWWWWWWWWWWWW
WsssW......WW.........WWW
Ws@sW......WW...........W
Wssss......WW.....E.....W
WWWss......WW...........W
W..........WW...........W
W..........WW...........W
W..........WW...........W
W..........WW......WsssWW
WEWWWWWWWWWWW......ss@ssW
W..........WW......ssssWW
W.......................W
W.......................W
WWWWWWWWWWWWWWWWWWWWWWWWW