WWWWWWWWWWWWWWWWWWWWWWWWW
W...W.................WWW
W.@.....................W
W.......................W
WWWWW...............WWWWW
W.......................W
W.......................W
W.......................W
W.......................W
W.......................W
W.......................W
W.......................W
W.......................W
WWWWWWWWWWWWWWWWWWWWWWWWW