WWWWWWWWWWWWWWWWWWWWWWWWW
W...sss..ddd...l........W
W...s....d..d..l........W
W.....s..d..d..l........W
W...sss..ddd...llll.....W
WWWWWWWWWWWWWWWWWWWWWWWWW
W.@........ll.........E.W
W.@........ll.........E.W
WWWWWWWWWWWWWWWWWWWWWWWWW
W...ssss..s..s..........W
W...s.....s..s..........W
W...ssss..s..s..........W
W...s.....s..s..........W
WWWWWWWWWWWWWWWWWWWWWWWWW