WWWWWWWWWWWWWWWWWWWWWWWWW
W...WssssssWW.........WWW
W.s.WssssssWW...........W
W....ssssssWW.....E.....W
WWW.lllllllWW...........W
W..........WW...........W
W..........WW...........W
W..........WW...........W
W..........WW...........W
W...E......WW........s..W
W..........WW...........W
WsssssssssssssssssssssssW
WsssssssssssssssssssssssW
WWWWWWWWWWWWWWWWWWWWWWWWW