WWWWWWWWWWWWWWWWWWWW
W...W..............W
W.@................W
W..................W
WWWWW..........WWWWW
W..................W
W..................W
W..................W
W..................W
W..................W
W..................W
W..................W
W..................W
W..................W
W..................W
W..................W
W..................W
W..................W
W..................W
WWWWWWWWWWWWWWWWWWWW