####################
#...#..............#
#.@.......W........#
#.........W........#
#####..........#####
#..................#
#.....WWW..........#
#..................#
#..................#
#..................#
#..................#
#..................#
#..................#
#..................#
#..................#
#..................#
#..................#
#..................#
#..................#
####################