WWWWWWWWWWWWWWWWWWWWWWWWW
W...W.................WWW
W.@.....................W
W.................E.....W
WWWWW...............WWWWW
W.......................W
W.......................W
W.....sss....lll........W
W....s........ll........W
W.....ss.....l.......@..W
W...........l...........W
W.......................W
W.......................W
WWWWWWWWWWWWWWWWWWWWWWWWW