WWWWWWWWWWWWWWWWWWWWWWWWW
W...Wsssssssssssssss..WWW
W.@...ssssssssssssss....W
W.....ssssssssssssE.....W
WWWWW.......W.......WWWWW
W...W.......W...........W
W...W.......W...........W
W...W.sss...Wlll..WWWWWWW
W...Wsssss....ll........W
W.....sss..w.l.......@..W
W......s...wl...........W
W......s...w............W
W...ssss...w............W
WWWWWWWWWWWWWWWWWWWWWWWWW