WWWWWWWWWWWWWWWWWWWWWWWWW
WsssssssssssssssssssssssW
Ws@sssssssssssssssssEsssW
WsssssssssssssssssssssssW
WsssssssssssssssssssssssW
WssssWsssWsssWsssWsssWssW
WssssWsssWsssWsssWsssWssW
W..W...W...W...W...W....W
W..W...W...W...W...W....W
W....W.......W...W...@..W
W....W.......W...W.....WW
W.......................W
W.......E...............W
WWWWWWWWWWWWWWWWWWWWWWWWW