WWWWWWWWWWWWWWWWWWWWWWWWW
W...W.................WWW
W.@.WWW.W...............W
W.....W.W.........E.....W
WWWWW.W.W...........WWWWW
W.....W.W...............W
W.WWWWW.W...............W
W.......W...............W
WWWWWWWWW..........WWWW.W
W..................W.@..W
W..................W....W
W...E.E............WWW.WW
W.......................W
WWWWWWWWWWWWWWWWWWWWWWWWW