WWWWWWWWWWWWWWWWWWWWWWWWW
W...sss..ddd...l........W
W...s....d..d..l........W
W.....s..d..d..l........W
W...sss..ddd...llll.....W
WWWWWWWWWWW.WWWWWWWWWWWWW
W.@.......W.W.........E.W
W.@.....w.....W.......E.W
WWWWWWWWWWW.WWWWWWWWWWWWW
W...ssss..s..s..........W
W...s.....s..s..........W
W...ssss..s..s..........W
W...s.....s..s..........W
WWWWWWWWWWWWWWWWWWWWWWWWW